NO ./resources/wall_north.xpm
SO ./resources/wall_south.xpm
WE ./resources/wall_west.xpm
EA ./resources/wall_east.xpm

F 100,50,50
C 200,80,90

        1111111111111111111111111
        1000000000000000000000001
        1100000000000000000000001
        1000000000000000000000001
111111111000000000000000000000001
100000000011111111110000000011111
10000000000110010000000000001
1000N000011111110000000000001
10000000000011010000000000001
10000000000000000000000000001
10000000000000000001010000001
11000001110101011111011110101
11110111 1110111 101111010001
11111111 1111111 111111111111