
NO ./resources/wall_north.xpm
SO ./resources/wall_south.xpm
WE ./resources/wall_west.xpm
EA ./resources/wall_east.xpm

F 139, 169, 119
C 3, 213, 255

1111111111111111111111111
1000000000110000000000001
1011000001110000000000001
100100000000000000000000111111111
111111111011000001110000000000001
100000000011000001110111111111111
11110111111111011100000010001
11110111 11111011101010000001
11000111110101011100000010001 
10000000000000001100000010001
1000E000000000001101010010001
1100000111010101111101111000111
11110111 1110101 101111010001
11111111 1111111 111111111111