NO ./labirint/north.xpm
SO ./labirint/north.xpm
WE ./labirint/north.xpm
EA ./labirint/north.xpm

F 139, 69, 19
C 3, 213, 255

1111111111111111111111111
1000000000110000000000001
1011000001110000000000001
100100000000000000000000111111111
111100111011000001110000000000001
100000000011000001110111111111111
11110111111111011100000010001
11110111 11111011101010010001
11000111110101011100000010001 
10000000000000001100000010001
1000E000000000001101010010001
1100000111010101111101111000111
11110111 1110101 100011010001
11111111 1110001 1111111111111111
11111111111000001110000000000111
100000000011000001110111111111111
11001111111001110000001000111
11010111 1111101110101001000111111111111
110001111101010111000000100010000000000111
10000000000000001100000010001100000000001111111
100000000000000011010100100000001111011111111
1000000000110000011101111111111111111111
11110111111111011100000010001
11110111 11111011101010010001
11000111110101011100000010001 
10000000000000001100000010001
10001000000000001101010010001
11111111111111111111111111111